      ▗▌    ▜▘   ▐                                                                                        ▌ ▌        ▌            ▛▀▖       ▖      ▐  
       ▌    ▐ ▛▀▖▜▀ ▙▀▖▞▀▖                                                                                ▝▞▞▀▖▀▜▘▝▀▖▌▗▘▌ ▌▙▀▖▝▀▖ ▙▄▘▙▀▖▞▀▖▗▖▞▀▖▞▀▖▜▀ 
       ▌ ▗▖ ▐ ▌ ▌▐ ▖▌  ▌ ▌                                                                                 ▌▌ ▌▗▘ ▞▀▌▛▚ ▌ ▌▌  ▞▀▌ ▌  ▌  ▌ ▌ ▌▛▀ ▌ ▖▐ ▖
      ▝▀ ▝▘ ▀▘▘ ▘ ▀ ▘  ▝▀                                                                                  ▘▝▀ ▀▀▘▝▀▘▘ ▘▝▀▘▘  ▝▀▘ ▘  ▘  ▝▀ ▄▘▝▀▘▝▀  ▀ 
                                                                                                                                                      
                                                                                                                                                      
      +--------------------------------------------------------------------+       +=================================================================+
      |                                                                    |       | <                         ねこ                                  |
      |                                                                    |       |-----------------------------------------------------------------|
      |                                                                    |       |                                                                 |
      |                                                                    |       |                                                                 |
      |                                                                    |       |                                                                 |
      |                                                                    |       |                                                                 |
      |                                                                    |       |                                                                 |
      |                                                                    |       |                                                                 |
      |                                                                    |       |                                                                 |
      |                                                                    |       |                                                                 |
      |                                                                    |       |                                                                 |
      |                                                                    |       |                                                                 |
      |                                                                    |       |                                                                 |
      |                                                                    |       |                                                                 |
      |                                                                    |       |                                                                 |
      |                                                                    |       |                                                                 |
      |                                                                    |       |                                                                 |
      |                                                                    |       |                                                                 |
      |                                                                    |       |                                                                 |
      |                                                                    |       |                                                                 |
      |                                                                    |       |                                                                 |
      |                                                                    |       |                                                                 |
      |                                                                    |       |=================================================================|
      |                                                                    |       |                                                                 |
      |                                                                    |       +-----------------------------------------------------------------+
      |                                                                    |                                                                          
      |                                                                    |                                                                          
      |                                                                    |                                                                          
      |                                                                    |                                                                          
      |                                                                    |                                                                          
      |                                                                    |                                                                          
      |                                                                    |                                                                          
      +--------------------------------------------------------------------+                                                                          
                                                                                                                                                      
                                                                                                                                                      
                                                                                                                                                      
                                                                                                                                                    
