                                                                    
                                                                    
                                                                    
   ▄    ▄   ▄           █                                           
   ▀▄  ▄▀ ▄▄█▄▄  ▄   ▄  █▄▄▄    ▄▄▄    ▄ ▄▄                         
    █  █    █    █   █  █▀ ▀█  █▀  █   █▀  ▀                        
    ▀▄▄▀    █    █   █  █   █  █▀▀▀▀   █                            
     ██     ▀▄▄  ▀▄▄▀█  ██▄█▀  ▀█▄▄▀   █                            
                                                                    
                  ▄▄▄▄                  ▄                           
                 █▀   ▀ ▄   ▄   ▄▄▄   ▄▄█▄▄   ▄▄▄   ▄▄▄▄▄           
                 ▀█▄▄▄  ▀▄ ▄▀  █   ▀    █    █▀  █  █ █ █           
                     ▀█  █ █    ▀▀▀▄    █    █▀▀▀▀  █ █ █           
                 ▀▄▄▄█▀  ▀█    ▀▄▄▄▀    ▀▄▄  ▀█▄▄▀  █ █ █           
                         ▄▀                                         
                        ▀▀                                          
                                                                    
                                        ▄ ▄                         
             ▄▀  █  ▀▀▀█▀▀▀  █   ▀▀▀█▀▀▀ ▀ ▀ ▀▄                     
             █   █   ▄▄█▄▄   █    ▄▄█▄▄       █                     
             █   █     █     █      █         █                     
             █   █  ▄▀▀█▀▄   █   ▄▀▀█▀▄       █                     
             ▀▄  █▀ ▀▄▄▀  ▀   █▀ ▀▄▄▀  ▀     ▄▀                     
                                                                    
                                                                    
             ██         ▄ ▄  ▄     ▄▄▄▄█▄▄▄   ▄▄▄▄▄                 
          ▄▄██▄▄▄▄▄   ▄▀▄▀ ▄█▄▄▄▄    ▄ █         ▄▀                 
          █▄▄▄▄▄▄▄█   ▄▀█ ▀  █▄▄▄   █ ██       ▄▀▄▄                 
          █▄▄▄▄▄▄▄█     █    █▄▄▄    ▀█       ▀ ▄▄ █                
          █▄▄▄▄▄▄▄█     █    █        █        ▀▄▄█▀                
                                                                    
                                                                    
