▛▚▖▄▄▄▄▄▄▗▞▜
▚ ▛      ▜ ▞
 ▛ ▜   ▜  ▜ 
 ▌   ▄    ▐ 
 ▚  ▀ ▀   ▞ 
  ▀▀▀▀▀▀▀▀  
